[shortname]
a1id=A1
a2id=A2
adjustBS=Adj.BS
anglebF=A
angleSegment=ASeg
angleValue=A
apexAngle=AC
apexAngleHalf=AC/2
average=Avg
bestFit=B-Fit
bestFit2d=2DFit
bestFit3d=3DFit
circularPitch=CircP
coordPolAngle=A
coordPolHeight=H
coordPolRadius=R
declinationAngle=DecAng
diameter=D
diameter2id=D2
distance=Dist
distance2d=Dist
distanceCart=CartDist
distanceGage=Gage Dist
distancePol2d=2D Dist
distancePol3d=3D Dist
elementAngle=Fea-Ang
enclosedAngle=InclAng
endAngleUAxis=EndA
expansionA=Lgth
expansionB=Wdth
gap=Gap
form=Form
halfAxisAngle=HA-An
heightCf=Height
inclinationAngle=TiltAng
len=Length
length=Length
lengthOfAxis=PerpLe
linearPitch=LinP
maximum=MaxValue
minimum=MinValue
planeAngle=PlnAng
radius=R
radius2id=R2
resultElement=ResEle
rotationAngle=RotAng
twoPtDiameter=2PtD
waveness=Waviness
weight=Weight
width=Width
xValue=X
yValue=Y
zValue=Z
gdtAngle=Ang
gdtCumAxRun=CumAxRun
gdtCumRadRun=CumRadRun
gdtCoa=Coa
gdtCon=Con
gdtCyl=Cyl
gdtFlat=Flat
gdtFlatRef=Zone Flat
gdtFlatUnit=Flat/Un
gdtPar=Par
gdtParRec=ParRec
gdtPerp=Perp
gdtPerpRec=PerpRec
gdtPos=Pos
gdtPos1d=Po1d
gdtPosPol2d=Po2d
gdtPosPol3d=Po3d
gdtPosRec=PosRec
gdtPosRec2d=PK2d
gdtProfile=Prof
gdtProfileOfALine=LinP
gdtRound=Roun
gdtRoundRef=RoRf
gdtRunFlat=RunFlt
gdtRunRound=Run
gdtSpacePoint=PtDist
gdtStraight=Strght
gdtStraightCart=StCrt
gdtStraightCartRef=StCR
gdtStraightPol=StPol
gdtStraightPolRef=StPR
gdtStraightRef=StRL
gdtSym=Sym
graphicElement=Graphics
curveForm=CurvForm